Deleterious (adj) - subtly or unexpectedly harmful
Gullible (adj) - easily deceived
Verbose (adj) - wordy
Xenophobia (noun) - a fear or hatred of foreigners or strangers
Vicissitude (noun) - a change or variation; ups and downs
Cacophony (noun) - harsh, jarring noise
Syncopation (noun) - temporary irregularity in musical rhythm
Zenith (noun) - the point of culmination; peak
Dogmatic (adj) - dictatorial in one's opinions
Lexicon (noun) - The vocabulary of a language, an individual speaker or group of speakers, or a subject
Eclectic (adj) - selecting from or made up from a variety of sources
Dispossess (verb) - deprive (someone) of land, property, or other possessions
Nebulous (adj) - (of a concept or idea) unclear, vague, or ill-defined
Ingenuous (adj) - showing innocence or childlike simplicity
Lethargic (adj) - acting in an indiffernt or slow, sluggish manner
Capitulate (verb) - cease to resist an opponent or an unwelcome demand; surrender
Tome (noun) - book, usually large and academic
Opacity (noun) - the condition of lacking transparency or translucence; opaqueness
Cogent (adj) - convinicing and well-reasoned
Machination (noun) - plot or scheme especially to do harm; a secret political clique or faction
Pariah (noun) - an outcast
Modulate (verb) - exert a modifying or controlling influence on
Pragmatic (adj) - practical, as opposed to idealistic
Discern (verb) - to perceive or recognize
Multifarious (adj) - diverse
Antithesis (noun) - a person or thing that is the direct opposite of someone or something else
Perfunctory (adj) - done in a routine way; indifferent
Traverse (verb) - to go or travel across, over, along or through
Abdicate (verb) - to give up a position, right, or power
Convoluted (adj) - intricate and complicated
Juncture (noun) - point of time, especially where two things are joined
Hyperbole (noun) - purposeful exaggeration for effect
Arbitrary (adj) - determined by chance or impulse
Latent (adj) - potential that is not readly apparent
Distend (verb) - to swell, inflate, or bloat
Tenuous (ad) - very weak or slight
Perspicacious (adj) - of acute mental vision or discernment
Symbiosis (noun) - cooperation; mutual helpfulness
Kudos (noun) - fame, glory, or honor
Mercurial (adj) - quick, shrewd, and unpredictable
Consternation (noun) - feelings of anxiety or dismay, typically at something unexpected
Monolithic (ad) - (of an organization or system) large, powerful, and intractably indivisible and uniform
Itinerant (adj) - wandering from place to place; unsettled
Waver (verb) - to fluctuate between choices
Trepidation (noun) - a feeling or fear or agitation about something that may happen
Invidious (adj) - envious, obnoxious, or offensive; likely to premote ill-will
Antagonize (verb) - to annoy or provoke to anger
Loquacious (adj) - talkative
Propitiate (verb) - win or regain the favor of (a god, spirit, or person) by doing something that pleases them
Advocate (verb) - to speak in favor of
